NO ./textures/texture_1.png
SO ./textures/texture_2.png
WE ./textures/texture_3.png
EA ./textures/texture_4.png

C 111,111,111
F 127,127,127

S 1 1 ./textures/sprite_char_1_multi_12.png 12
S 1 2 ./textures/sprite_char_2_multi_12.png 12

111111
10D001
1010W1
111111