        NO ./textures/texture_1.png
        SO ./textures/texture_2.png
        WE ./textures/texture_3.png
        EA ./textures/texture_4.png
        DOOR ./textures/texture_door.png


F 46,31,8
C 4,209,209



111     1111111111111111111111111
101     1000000000110000000000001
111     1011000001110000000000001
        1001000000000000000000001
111111111011000001110000000000001
100000000011000001110111111111111
11110111111111011100000010001
11110111111111011101010010001
1100N000110101011100000010001
10000000000000001100000010001
10000000000000001101010010001
1100000111010101111101111000111
11110111 1110101 101111010001
11111111 1111111 111111111111